
ما عدد سكان أمريكا؟	ما هو المناخ السائد في أمريكا؟	no
كم يصل إجمالي مساحة الجبل الأسود؟	ما هي المساحة الجغرافية لموناكو؟	no
كم يبلغ عدد سكان القدس؟	ما سبب تسمية القدس؟	no
هل من الضروري عمل حمام بخار للوجه؟	ما أهمية عمل حمام بخار للجسم؟	no
ما طريقة تحضير محشي البطاطس ؟	من طرق تحضير  البطاطا؟	no
من طرق تحضير الفُقع بالزيت؟	من طرق تحضير الفُقع ؟	no
ما هي اللغة الرسمية لمعظم دول قارة أفريقيا؟	ما اسم المنطقة التي ظهرت فيها مملكة كوش؟	no
أين تقع كاتدرائية جاكرتا؟	ما الذي يميز بناء كاتدرائية جاكرتا؟	no
ما هي العاصمة الليبية؟	ما هي اللغة الرسمية لليبيا؟	no
ما طريقة تحضير الجوزيّة بجوز الهند؟	من طرق تحضير جوز الهند؟	no
ما هي حدود الصين البرية؟	أين تقع جمهورية الصين؟	no
من طرق حساب فائدة البنك البسيطة؟	ما هي الفوائد ؟	no
هل هناك طريقة لحساب فائدة البنك المركبة؟	ما هي الفوائد ؟	no
متى حصلت جزر القمر عن استقلالها الرسمي عن فرنسيا؟	إلى كم تصل مساحة جزر القمر الجغرافية؟	no
ما طريقة تحضير المصابيب ؟	من طرق تحضير المصابيب دون بيض؟	no
ما هي وظيفة الاشرافية لمدير شؤون الموظفين ؟	من هو مدير شؤون الموظفين ؟	no
من طرق تحضير صلصة الشوكلاتة بالنسكافية ؟	من طرق تحضير  الشوكولاته ؟	no
ما هو الحب؟	كيف أتعلم الحب؟	no
ما معنى الراعي  ؟	هل هناك اية قرآنية عن الراعي والرعية ؟	no
ما هي حقوق المرأة في العصر الجاهلي؟	ما هي حقوق المرأة في العصر الإسلامي؟	no
من طرق تحضير  نرجسكو الدّجاج؟	من طرق تحضير الدجاج؟	no
كم تشكل نسبة الأردنيين الأصل في المملكة الأردنية؟	ما لغة الأردن الرسمية؟	no
كيف أعرف نتيجة الاستخارة؟	كيف أعرف نتيجة الامتحان؟	no
ما هي الأهمية التاريخية لسور الصين العظيم؟	من هو الشخص الذي قام ببناء سور الصين العظيم؟	no
كم يبلغ عدد سكان رومانيا؟	كم يبلغ عدد سكان البرتغال؟	no
كيف يمكن استرجاع نظام تشغيل جهاز الأندرويد؟	ما هي مميزات نظام الأندرويد؟	no
ما هي الأجيال التي مرت على تطور الحاسوب؟	كيف تطور الحاسوب؟	no
بماذا تتميز آلات التصوير الحديثة؟	متى ظهرت أول كاميرا؟	no
ما كيفية تحضير زنود الست بخبز التوست ؟	ما طريقة تحضير زنود الست ؟	no
من خيارات الدفع على الانترنت ؟	ماذا نقصد بالتسوق عبر الإنترنت؟	no
من طرق تحضير العصيدة  ؟	من طرق تحضير العصيدة باللحم  ؟	no
ما أسباب ضعف الشخصية؟	ما هو ضعف الشخصية؟	no
كيف احضر حلوى اللؤلؤ؟	من طرق تحضير  اللؤلؤ ؟	no
كيف احضر البقسماط بالسمسم؟	من طرق تحضير  السمسم ؟	no
ما هي عملة السعودية؟	متى صدرت عملة السعودية؟	no
من اقسام القروض ؟	من شروط القروض ؟	no
متى ضُمت قناة السويس بشكلٍ كامل لمصر؟	متى ضم نهر النيل لمصر؟	no
ما أهمية سور الصين العظيم التاريخية؟	من هو الشخص الذي قام ببناء سور الصين العظيم؟	no
كيف أحافظ على جمال وجهي؟	كيف أحافظ على جمال جسمي؟	no
كيف يؤثر النوم على جمال البشرة؟	هل يؤثر النوم على صحة الشعر؟	no
ما هو الشعار الوطني للبرتغال؟	ما هو النظام الحاكم للبرتغال؟	no
كيف احضر القرنبيط المقلي؟	من طرق تحضير القرنبيط؟	no
ما طريقة تحضير الستيك بالمشروم والكريمة؟	من طرق تحضير المشروم؟	no
ما المرتبة المساحية للقارة القطبية الجنوبية؟	من هي القارة الأكثر استقطاباً للسياح؟	no
متى لا أضع الفازلين على بشرتي؟	هل يستخدم الفازلين في علاج الفطريات؟	no
كيف أشتري من المتاجر عن طريق الماستر كارد؟	هل لبطاقة الماستر كارد مخاطر؟	no
كيف احضر الفوتشيني؟	من طرق تحضير الفوتشيني  بالفطر؟"	no
من هم مكتشفو قارة أوروبا؟	من هي ثالث أكبر القارات مساحةً؟	no
من طرق تحضير اصابع جبنة الموزريلا؟	,من طرق تحضير اصابع الجبنة  ؟	no
ما هي أكبر جزيرة في قارة أفريقيا؟	ما هي اللغة الأكثر شيوعاً في قارة أوروبا؟	no
كم تبلغ نسبة المسلمين في المملكة الأردنية؟	ما ي اللغة الرسمية للأردن؟	no
من سلبيات التكنولوجيا ؟	ما تعريف التكنولوجيا ؟	no
كيف أمارس تمرين الضغط المثلث؟	كيف أؤدي تمرين الضغط بالوقوف على يدي؟	no
ما أهمية تمارين الضغط؟	ما هو تمرين الضغط بالوقوف على اليدين؟	no
كيف اصنع الجبنة البيضاء في المنزل ؟	من طرق صنع الجبنة الصفراء  منزلياً؟	no
ما هي نسبة المسلمين في الصين؟	ما هي نسبة معتنقي الديانة المسيحية في الصين؟	no
ما هي صفات العرب في العصر الجاهلي؟	ما هي صفات العرب؟	no
ما هو ماسك العسل لتطويل الشعر؟	ما فوائد العسل للشعر؟	no
ما كيفية صنع ليالي لبنان بالكراميل؟	ما طريقة تحضير ليالي لبنان ؟	no
ما عاصمة لاتفيا؟	ما اسم عاصمة إيرلندا؟	no
ما الذي يميّز البشرة الدهنية؟	ما هي البشرة الدهنية؟	no
ما هو المناخ السائد في سنغافورة؟	إلى كم نسمة يصل عدد سكان سنغافورة؟	no
من وسائل الاشهار ؟	ماذا نقصد بالاشهار ؟	no
ما هي واجبات المواطن؟	ما حقوق المواطن وواجباته في الإسلام؟	no
ما طريقة تحضير كيكة التمر بالعسل ؟	من طرق تحضير كيكة التمر ؟	no
ما هو سبب ظهور التجارة بالاسهم ؟	ما هو تعريف السهم ؟	no
من طرق تحضير  بودنج الأرز الهندي؟	من طرق تحضير  الأرز الهندي؟	no
ما فائدة الجدوى العملية ؟	ما هي دراسة الجدوى ؟	no
أين تقع الفاتيكان في قارة أوروبا؟	أين تقع المملكة المتحدة في قارة أوروبا؟	no
ما هو ملخص التحليل المالي ؟	ماذا نقصد بالتحليل المالي ؟	no
متى يجب خذ الحيطة والحذر عند تناول البقدونس؟	ما إجراءات الحيطة والحذر عند المرض؟	no
أين يقع الكولوسيوم تحديداً في ألمانيا؟	ما البلد التي يقع فيها الكولوسيوم؟	no
ما هي مميزات التجارة بالاسهم ؟	ما هو تعريف الاسهم؟	no
ما هي اسباب الكزيما؟	لماذا نصاب بالشرى؟	no
من طرق تحضير سلطة الكينوا والكوسا؟	من طرق تحضير سلطة الكوسا؟	no
كيف أستخدم الفايبر؟	ما هو الفايبر؟	no
كم تبلغ الكثافة السكانية في اليونان؟	ما هي كثافة ألمانيا السكانية؟	no
ما هو العجز؟	من انواع العجز؟	no
ما مفهوم المفوض له ؟	من هو المفوض ؟	no
ما طريقة تحضير كيكة جوز الهند البيضاء ؟	من طرق تحضير كيكة   البيضاء؟	no
ماذا يعني نظام الأندرويد؟	كيف يتم تطوير نظام الأندرويد؟	no
كم مكتب يوجد لجوجل حول العالم ؟	ما هي شركة جوجل ؟	no
هل للمشاريع الصغيرة اهمية ؟	ما خصائص المشاريع الصغيرة؟	no
من انواع الهجرة ؟	ما هي الهجرة ؟	no
كيف أتخلص من نحافة وجهي؟	ما هي طرق تنحيف الخدين؟	no
ما هي الأصنام التي عبدها العرب؟	ما هي الأصنام؟	no
كم يصل التعداد السكاني في ليتوانيا؟	كم يبلغ تعداد ليختنشتاين السكاني؟	no
من طرق تحضير الجريش بالدجاج؟	من طرق تحضير الجريش؟	no
ما هو نظام ويندوز7؟	كيف أحدث نظام الويندوز7؟	no
ما هو الفيس بوك؟	من اخترع الفيس بوك؟	no
ما هي تكلفة البناء لشنغهاي وورلد فينيشال سنتر؟	في أي عام تم بناء شنغهاي وورلد فينيشال سنتر؟	no
ماذا نقصد بالمدرسة الكلاسيكية؟	متى نشأت المدرسة الكلاسيكية ؟	no
متى ولد توفيق الحكيم؟	أين ولد توفيق الحكيم؟	no
من طرق تحضير الكبد والقوانص مع الأرز؟	من طرق تحضير الارز؟	no
ما طريقة تحضير صلصة البيتزا ؟	من طرق تحضير  البيتزا؟	no
في أي عام قررت الولايات الأمريكية مواجهة القوات البريطانية؟	من هم سكان أمريكا الحقيقيون؟	no
ما هي الاسهم ؟	ما هي سلبيات الاسهم ؟	no
ماذا كان يستخدم هرم تشيتشن قديماً؟	أين يوجد هرم تشيتشن؟	no
كيف نصلي الاستخارة؟	متى تصلى الاستخارة؟	no
ماذا نفعل بعد القيام بضبط المصنع؟	ما المقصود بضبط المصنع؟	no
ما هي الأقنعة التي تخفف من الدهون على الوجه؟	ما هي أهم المشروبات التي تحرق الدهون في الجسم؟	no
متى ظهرت كاميرات المنظار وأين؟	ما هي كاميرات المنظار؟	no
ما هي أجزاء الـ URL؟	ما المقصود بالـ URL؟	no
ماذا يوجد في المتحف القومي في كوالالمبور؟	أين توجد تماثيل الشخصيات البارزة لكوالالمبور؟	no
كيف يتم غرس الانتماء بطريقةٍ إيجابيّة لدى الاجيال	ما دور الأجيال القادمة؟	no
ما هو المناخ العام في سلطنة عُمان؟	ما هي عملة عمان الرسمية؟	no
ما هي تكنولوجيا الاستغناء عن الكتب؟	ما هي التكنولوجيا؟	no
هل يوجد إيجابيات للتابلت؟	ما مواصفات كاميرا التابلت؟	no
ما طريقة تحضير الكب كيك بالشوكولاتة  ؟	من طرق تحضير الكب كيك   ؟	no
ما طريقة تحضير كب كيك الجزر والقرفة دايت ؟	من طرق تحضير كب كيك الجزر والقرفة  ؟	no
كيف احضر كيك الشوكولاتة بدون بيض ؟	من طرق تحضير كيك الشوكولاتة ؟	no
من خصائص الرأسمالية ؟	ماذا نقصد بالرأسماليّة؟	no
ما طريقة تحضير البط بالبرتقال؟	من طرق تحضير البرتقال؟	no
ما هي المسافة التي تبعدها جزيرة فيجي عن أوكلاند؟	ما عاصمة جزيرة فيجي؟	no
ما طريقة تحضير البفتيك المشوي مع الصويا صوص ؟	كيف احضر البفتيك المشوي ؟	no
ما تعريف الحرية الموجبة ؟	ما هي الحرية ؟	no
ما هي لغة بلجيكيا الرسمية؟	ما هي مساحة بلجيكيا العامة؟	no
ما هي مساحة آيسلندا؟	ما هي لغة آيسلندا الرسمية؟	no
هل فيتامين د متواجد في الطعام؟	ما هي مصادر فيتامين ب12؟	no
من طرق تحضير الدجاج الصيني بالخضار؟	من طرق تحضير الدجاج؟	no
ما هي اشهر الدول في صناعة البخور ؟	ما هو البخور ؟	no
ما أهم الأقنعة التي تخفف من دهون الوجه؟	ما هي أهم المشروبات التي تحرق الدهون في الجسم؟	no
ما هو مفهوم التفويض؟	ما هي شروط التفويض ؟	no
ماذا نقصد بالبطالة الهيكلية ؟	ما هي البطالة ؟	no
ماذا يسبب حصى الكلى؟	ماذا تسبب البروتينات الصناعية للجسم؟	no
من ماذا تتكون الميزانية ؟	ما هي الميزانية ؟	no
ما هو نظام الأندرويد؟	ما هي أجهزة الاندرويد؟	no
متى ابتدأ تصنيع أجهزة التحكم عن بعد؟	من هو مخترع جهاز التحكم عن بعد؟	no
ما الذي يغطي نصف المساحة الجغرافيّة الروسيّة؟	ماذا يقع في القسم الجنوبي لأكبر دولة في العالم من حيث المساحة؟	no
ما هو نوع النظام الحاكم في بلجيكيا؟	ما هي لغة بلجيكيا الرسمية؟	no
ما اسم الدولة التي كانت أكبر دولة مصدرة في عام 2010؟	من يحكم جمهورية الصين؟	no
من طرق تحضير عجينة البيتزا بالحليب؟	من طرق تحضير عجينة البيتزا  ؟	no
كيف احضر  الكاتو السوري؟	من طرق تحضير الكاتو  ؟	no
كيف اكتشف الفازلين ؟	من اكتشف الفازلين ؟	no
ما هي المراسلات  الرسمية الخارجية؟	ما هي انواع المراسلات الادارية ؟	no
ما هي عصا السيلفي؟	من اخترع عصا السيلفي؟	no
ما هي الشبكات المتقدمة؟	ما هي شبكة النجمة؟	no
ما هي عاصمة جمهورية كانغو؟	ما هي عاصمة تشاد؟	no
من اهداف المشاريع الصغيرة ؟	ما خصائص المشاريع الصغيرة؟	no
ماذا نقصد بالهجرة الداخلية ؟	ما هي الهجرة ؟	no
من اهداف الصيدلة ؟	متى ظهرت الصيدلة ؟	no
كيف احضر كانتون صيني؟	من طرق تحضير الدجاج صيني؟	no
كيف تؤثر تقنية المعلومات على حياتنا ؟	ما مكونات تقنية المعلومات ؟	no
من أين تأتي فائدة لبن الزبادي؟	ما هي فوائد الزبادي للشعر؟	no
من هي البحيرة الثانية عالمياً من حيث العذوبة؟	كم يبلغ عدد سكان قارة أفريقيا؟	no
ما طريقة تحضير السبانخ باللحمة على الطريقة المصرية ؟	من طرق تحضير السبانخ ؟	no
ما هي اعراض الجدري؟	ما هي اعراض الاصابة بالامراض؟	no
ما هي مساحة اليونان الإجمالية؟	كم تبلغ مساحة ألمانيا؟	no
ما هي أنواع الاحتياجات الخاصة؟	ماذا نعني بذوو الاحتياجات الخاصّة؟	no
كم تبلغ المساحة الجغرافية لقارة أوروبا؟	ما هو عدد سكان قارة أمريكا الشمالية؟	no
ما طريقة تحضير كيكة الرهش ؟	من طرق تحضير كيكة  ؟	no
كيف اصنع الخشاف بالحليب ؟	ما طريقة عمل الخشاف ؟	no
ما هو الاسم الأصلي لجزيرة سقطرى؟	أين تقع جزيرة سقطرى؟	no
كيف احضر الحلاوة بالشعيريّة؟	من طرق تحضير   بالشعيريّة؟	no
ما عاصمة بوركينا فاسو؟	ما عاصمة الرأس الأخضر؟	no
ما هي فائدة الأرز المطحون مع الطماطم؟	هل يوجد فائدة من وضع الأرز المطحون مع الطماطم على الوجه؟	no
ما هي أعراض الحمل قبل قدوم الدورة؟	ما هي أعراض الحمل الكاذب؟	no
من طرق تحضير البيتي فور؟	من طرق تحضير  البيتي فور بالشوكولاته؟	no
كيف يتم تنظيف السجاد ؟	كيف انظف بقع القهوة عن السجاد؟	no
ما طريقة تحضير  كعب الغزال بالتمر؟	من طرق تحضير التمر؟	no
ما أهمية الفيسبوك في وقتنا الحالي؟	ما هو الفيسبوك؟	no
ما هي الجغرافيا لروسيا في القسم الشرقي؟	كم تبلغ مساحة روسيا؟	no
بماذا يفيد ماء الورد البشرة؟	ما هو ماء الورد؟	no
ما الذي ساهمته الصخور الأرضية للقارات على لسطح الأرض؟	ما عدد دول قارة أمريكا الجنوبية؟	no
من اسباب التضخم ؟	ما هو التضخم ؟	no
كيف احضر الزهرة المَقليَّة على الطريقة المصريّة؟	من طرق تحضير الزهرة المَقليَّة  ؟	no
ما اسباب تاخر نزول الحيض؟	ما هو الحيض؟	no
كيف احضر كيكة الجزر والقرفة دايت؟	من طرق تحضير كيكة الجزر والقرفة ؟	no
ما هي النصائح لتحضير ليالي لبنان ؟	ما طريقة تحضير ليالي لبنان ؟	no
ما هي التّنمية الاقتصاديّة؟	متى ظهرت التنمية الاقتصادية ؟	no
ما هي عاصمة الأردن؟	ما هي المحافظة الأقل عدداً من حيث السكان في الأردن؟	no
كيف يعمل فيروس كورونا؟	كيف يحدث مرض السارس؟	no
ما هي الطرق البسيطة لتعديل شاشة الكمبيوتر المقلوبة؟	مم تتكون شاشة الكمبيوتر؟	no
ما طريقة تحضير القلقاس المقلي؟	من طرق تحضير البط المقلي؟	no
كم تبلغ مساحة صربيا؟	ما هي المساحة الإجمالية لسان مارينو؟	no
كيف أفتح قفل هاتفي النوكيا؟	ما هو رمز قفل الهاتف؟	no
من طرق تحضير  حلوى الجزر؟	من طرق تحضير الجزر؟	no
كيف احضر مجدرة الفريكة؟	من طرق تحضير الفريكة؟	no
ما هو طول برج القاهرة؟	أين يوجد نهر النيل؟	no
ما طريقة تحضير كيكة البسبوسة  ؟	من طرق تحضير كيكة  ؟	no
ما تعريف القيم الجمالية؟	من خصائص القيم ؟	no
ما هي الهجرة ؟	من اسباب الهجرة ؟	no
من طرق تحضير حلاوة الجزر؟	من طرق تحضير كيكة الجزر؟	no
ما هو البخور ؟	ما هي اشهر الدول في صناعة البخور ؟	no
ما المقصود بالعصيدة؟	من طرق تحضير العصيدة باللحم  ؟	no
كم يصل ارتفاع قمة جبل تومانيفي في جزيرة فيجي؟	ما اسم أعلى قمة في جزيرة فيجي؟	no
ما طريقة تحضير كيك دون بيض وحليب ؟	من طرق تحضير كيك  ؟	no
كيف اكتشف قدرة البقدونس على خفض حمض اليوريك؟	ماهو حمض اليوريك؟	no
ما كيفية كتابة التفويض ؟	ما هي شروط التفويض ؟	no
ما اسم عاصمة الجبل الأسود؟	ما عاصمة موناكو؟	no
كيف احضر كيكة البسبوسة بالقشطة ؟	من طرق تحضير  كيكة  بالقشطة؟	no
ما طريقة تحضير  كب كيك بالبرتقال ؟	من طرق تحضير  كب كيك  ؟	no
من هي المدينة الأكبر في المغرب العربي؟	ما اسم المغرب قديماً؟	no
ما شكل أسنان الضفدع؟	كيف يكون شكل سيقان الضفادع؟	no
بماذا يستمتع الزائر في حديقة والت ديزني؟	أين توجد حديقة والت ديزني؟	no
ما هي الخطوات اللازمة لعمل قناع للوجه؟	أهم ماسكات الشعر	no
من طرق الاهتمام بذوي الاحتياجات الخاصة ؟	ماذا نعني بذوو الاحتياجات الخاصّة؟	no
لماذا يحدث مغص عند الحامل؟	لماذا يحدث المغص؟	no
ما اهداف الصيدلة ؟	متى ظهرت الصيدلة ؟	no
ما اسس التكنولوجيا ؟	ما تعريف التكنولوجيا ؟	no
ماذا نقصد بادارة المبيعات ؟	ماذا نقصد بالمبيعات ؟	no
ما عدد سكان البرازيل؟	ما هو المناخ السائد في البرازيل؟	no
كم مساحة الجزيرة الجنوبية الواقعة في نيوزلندا؟	في أي عام تم ضم جزر نيوزلندا رسمياً من قبل بريطانيا؟	no
هل يوجد حلول يدوية لتعديل شاشة الكمبيوتر المقلوبة؟	ما هي الشاشة المقلوبة ؟	no
متى تم العثور على أول خليج تابع لأستراليا من قبل الهولنديون؟	من أكتشف أستراليا؟	no
متى غزا الفرس سلطنة عمان؟	كم بقي الغزو الفارسي على عمان؟	no
كم يبغ عدد السكان في المملكة المتحدة؟	كم عدد سكان أوكرانيا؟	no
ما هي الثآليل؟	ما هو مسمار اللحم؟	no
متى نشأ الانتاج ؟	ماذا نقصد بالانتاج ؟	no
ما هو نظام البحرين الحاكم؟	ما هي لغة البحرين المعتمدة؟	no
ماذا تعرف قارة أوقيانوسيا؟	من كان سكان قارة أوقيانوسيا الأوائل؟	no
لماذا يستعمل البقدونس لعلاج تقلصات الامعاء و الاسهال؟	ما هو الإسهال؟	no
ما تأثير الصمغ العربي على الصحة ؟	ما هو الصمغ العربي ؟	no
كم يبلغ تعداد ليختنشتاين السكاني؟	كم يصل التعداد السكاني في لاتفيا؟	no
ما هي عاصمة نوفا سكوشا؟	ما اسم عاصمة أونتاريو؟	no
ماذا نعني بفن السرد؟	ما الهدف من فن السرد؟	no
كيف احضر مكعبات البطاطا الحلوة؟	من طرق تحضير مكعبات البطاطا ؟	no
كيف احضر كريمة الزبدة ؟	من طرق تحضير  الزبدة ؟	no
ماذا يوجد داخل أبراج البيت؟	في أي برج يوجد فندق فيرمونت؟	no
ما المقصود بالسندات ؟	ما فوائد السندات؟	no
ما هو أول متحف في إندونيسيا؟	في أي مدينة يوجد متحف بنك إندونيسيا؟	no
إلى أي درجة يعتبر الحاسوب مهماً؟	من اخترع الحاسوب؟	no
كيف تميز أنثى الضفدع صوت الذكر؟	كيف يتكاثر الضفدع؟	no
من مسؤوليات العبد اتجاه سيده ؟	ما المقصود بالعبد؟	no
ما هي الأعراض طويلة الأمد لفيتامين د؟	ما هي اعراض نقص فيتامين ب؟	no
ما هو أجمل المسارح وأقدمها يف العالم؟	في أي عام تم افتتاح دار الأوبرا؟	no
ما اسم عاصمة سلوفينيا؟	ما اسم عاصمة سلوفاكيا؟	no
ما هي عاصمة أوكرانيا؟	ما اسم عاصمة سويسرا؟	no
كيف يؤثر تناول القهوة على القلب والشرايين؟	ما هي أمراض القلب والشرايين؟	no
كم تصل الكثافة السكاية في ألمانيا؟	ما هي كثافة فنلندا السكانية؟	no
ما هو القرض المضمون  ؟	من انواع القروض ؟	no
متى سميت ليبيا بالمملكة الليبية؟	ما هي عاصمة ليبيا؟	no
بماذا تسمى أمريكا رسمياّ؟	ما أسماء القطاعات الداعمة للإقتصاد الأمريكي؟	no
كيف يعد تحمل المسؤولية صفة للشخصية القوية؟	ما هي تحمل المسؤولية؟	no
ما طريقة تحضير كيكة دقيق الذرة؟	من طرق تحضير كيكة ؟	no
من هو مدير قاعدة البيانات؟	ماذا نقصد بقواعد البيانات؟	no
من طرق تحضير الملوخيّة بالأرانب؟	من طرق تحضير الملوخية؟	no
من طرق تحضير   كيكة البستا فلورا ؟	من طرق تحضير  طريقة إعداد الكيك؟	no
ماذا نعني بالاسماء التجارية ؟	ما هي مواصفات الأسماء التجاريّة؟	no
ما هي الرسالة الرسمية؟	ما عناصر الرسالة الرسمية؟	no
من اين تأتي القيم ؟	من خصائص القيم ؟	no
ما طريقة تحضير صلصة الشوكولاتة بالقشطة؟	من طرق تحضير  الشوكولاته ؟	no
من طرق تحضير حشوة قطع اللحم المفروم للبيتزا؟	من طرق تحضير حشو  اللحم  ؟	no
أين تقع البرتغال؟	ما الذي يميز جزر الأزور؟	no
ما هي حدود المغرب الغربية؟	ما هي المساحة الإجمالية للمغرب؟	no
في أي مكان توجد جامعة المحيط الهادئ؟	كم تبلغ نسبة محو الأمية في جزيرة فيجي؟	no
ما مميزات العمل التطوعي ؟	ما فوائد العمل ؟	no
أين توجد قلعة الكرملين؟	ماذا يوجد في القسم الشرقي لروسيا؟	no
ما خطوات انشاء الواح شمسية في المنزل ؟	ما انواع الالواح الشمسية ؟	no
متى وقعت غزوة تبوك؟	ما نتائج غزوة تبوك؟	no
من أين اشتقت كلمة بترول؟	من أين نحصل على  البترول؟	no
ما الأسباب التي تضعف الشخصية؟	ما هو ضعف الشخصية؟	no
ما هو مناخ نيوزلندا على مدار السنة؟	,ما هو العدد الإجمالي لسكان نيوزلندا؟	no
لماذا تشعر الحامل بالمغص؟	لماذا يحدث المغص؟	no
ما هي مرتكزات الاشتراكية؟	ما هي الاشتراكية ؟	no
ما هي حالة الطقس العامة في مدغشقر شتاءً؟	ما حالة الطقس في مدغشقر صيفاً	no
كم يبلغ التعداد السكاني في النمسا؟	كم يبلغ التعداد السكاني في هولندا؟	no
ماذا يحتوي متحف توستو؟	في أي عام انشئ متحف توستو؟	no
ما طريقة تحضير الجلو بالحليب المكثّف؟	من طرق تحضير  الحليب المكثّف؟	no
في أي قارة تقع نيوزلندا؟	ما هي مساحة الجزيرة الشمالية النيوزلندية؟	no
ما هي قرى  مدينة قضاء الصناعية؟	من اقسام مدينة قضاء الصناعية ؟	no
كم تبلغ مساحة أبو ظبي؟	ما عدد سكان أبو ظبي؟	no
في أي عام وقعت غزوة بدر الكبرى؟	في أي عام وقعت غزوة المريسيع؟	no
من نتائج التحليل المالي الداخلية؟	ماذا نقصد بالتحليل المالي ؟	no
ما هي أنواع السياحة؟	ما هي سياحة المعارض؟	no
ما طريقة تحضير  الحليب المكثَّف؟	من طرق تحضير  الحليب المكثَّف بالشوكولاتة؟	no
ما هي نسبة المسلمين داخل جزر القمر؟	ما هي اللغة المعتمدة في جزر القمر؟	no
متى يبدأ الطفل بالنطق؟	متى يناغي الطفل؟	no
كيف احضر أرنب مسبّك؟	من طرق تحضير أرنب مسلوق؟	no
كيف احضر لفائف الباذنجان بالجبن والأعشاب؟	من طرق تحضير لفائف  بالجبن ؟	no
بماذا يصطاد الضفدع فريسته؟	كيف يأكل الضفدع؟	no
كيف تطور الهاتف المحمول؟	كيف ظهر الهاتف الخلوي؟	no
كيف احضر أضنة كباب؟	من طرق تحضير الكباب؟	no
في اي عام تم الإعلان عن إستقلال ليبيا وتسميتها بالمملكة الليبية؟	ما هي عاصمة ليبيا؟	no
من طرق تحضير كب كيك النوتيلا؟	من طرق تحضير   النوتيلا؟	no
ما هي النسبة المئوية للسكان الأوروبيون في نيوزلندا؟	ما اسم القبيلة التي يوجد فيها السكان النيوزلندييون الأصليون؟	no
ما هو المعلم الذي يرمز إلى الحب في باريس؟	على ماذا يحتوي متحف اللوفر؟	no
ما هي القيم الاجتماعية ؟	من خصائص القيم ؟	no
هل يوجد سلبيات للتعليم التكنولوجي؟	ما هي إيجابيات التعليم التكنولوجي؟	no
لماذا نصاب بنقص فيتامين د؟	ما هي اسباب نقص فيتامين ب؟	no
من طرق تحضير الزهرة المَقليَّة على الطريقة المصريّة؟	من طرق تحضير الزهرة المَقليَّة  ؟	no
ما هو أهم نهر في قارة أفريقيا؟	ما هي اللغة الأكثر شيوعاً في قارة أفريقيا؟	no
أين تقع جيبوتي؟	ما عاصمة جيبوتي؟	no
ما هي مساحة مدغشقر الإجمالية؟	ما عدد سكان مدغشقر؟	no
كيف احضر إيدام اللوبياء باللحم؟	من طرق تحضير اللحم؟	no
ما هي أسباب ضعف الشخصية؟	ماذا نعني بالشخصية الضعيفة؟	no
كيف يختلف قلب الضفدع عن الإنسان؟	,كيف تختلف الدورة الدموية لدى الضفدع عن الإنسان؟	no
ما هي طريقة تعديل الشاشة المقلوبة في نظام لينكس؟	ما سبب الشاشة المقلوبة؟	no
ما هو نوع أول جهاز خلوي تم اختراعه؟	بماذا يختلف الهاتف الخلوي عن الأرضي؟	no
ما هي نتائج التعداد السكاني لروسيا في عام 2016؟	ما هي نسبة المسلمون في روسيا؟	no
ما هي أهمية الحاسوب؟	من اخترع الحاسوب؟	no
ما هو الجبل الذي يعتبر أعلى قمة في أوروبا؟	أين يوجد جبل البروس؟	no
ما طريقة تحضير  الحلاوة بالشعيريّة؟	من طرق تحضير   بالشعيريّة؟	no
كم تم اكتشاف فيتامين ب12؟	كيف اكتشف فيتامين ب2؟	no
لماذا نصاب بالكيس الشعري؟	لماذا نصاب بالكيس الدهني؟	no
من طرق تحضير الفوندون؟	من طرق تحضير  الفوندون بالعسل؟	no
ما هي تقنية المعلومات؟	متى ظهرت تقنية المعلومات؟	no
ما ارتفاع القمة التي يطل عليها ماتشو بيتشو؟	ما أهم المباني الموجودة في ماتشو بيتشو؟	no
ما اسم برتغال الرسمي؟	ما العملة الرسمية للبرتغال؟	no
ما هي الاسباب التي تمنع الغنى ؟	ما هي وسائل تحقيق الغنى؟	no
بماذا تتميز آلات التصوير بدون مرآة؟	من اخترع آلات التصوير بدون مرآة؟	no
ما مناخ ولاية ألبرتا السائد؟	ما المناخ السائد في ولاية نيو برونزويك؟	no
كم عدد الموظفين الذين ساعدوا في بناء برج خليفة؟	كم يصل مقاد تكلفة بناء برج خليفة؟	no
هل تؤثر التربية على قوة الشخصية أو ضعفها؟	ما هو علم التربية؟	no
كيف احضر  كيكة النسكافيه؟	من طرق تحضير  طريقة إعداد الكيك؟	no
ما هي فكرة اختراع جهاز التحكم عن بعد؟	ما هي أهم الاجهزة التي تستخدم جهاز التحكم عن بعد؟	no
ما شعار البرتغال الوطني؟	ما هو النظام الحاكم للبرتغال؟	no
كيف يمكن فك قفل رمز هاتف النوكيا؟	ما هو رمز قفل الهاتف؟	no
ما هي عملية الإحماء؟	كيف تكون ممارسة تمرين الضغط؟	no
ما هو ماسك المايونيز لتطويل الشعر؟	ما هو المايونيز؟	no
كم تبلغ مساحة روسيا؟	ما عدد سكان روسيا؟	no
ما هي عاصمة رينيون؟	ما هي عاصمة موزمبيق؟	no
هل هناك مثال على حساب الفائدة البسيطة ؟	ما هي الفوائد ؟	no
ما هو الاسم السياسي لسنغافورة؟	أين تقع جمهورية سنغافورة؟	no
لمن قصيدة يا أيها النّاس جازَ المدحُ قدرَكمُ؟	,ما مناسبة قصيدة يا أيها النّاس جازَ المدحُ قدرَكمُ,	no
ما حكم إفطار المريض في رمضان؟	ما حكم إفطار المسافر في رمضان؟	no
ما هو عمل هيئة الأمم المُتّحدة ؟	ما هي الدولة المتحدة ؟	no
ما هي الوضعية التي يحتاجها الجسم لممارسة تمرين الضغط؟	كيف أخفض جذعي أثناء ممارسة تمارين الضغط؟	no
كيف أستفيد من الليمون لتفتيح البشرة؟	ما هي طريقة عمل عصير الليمون؟	no
ما تاريخ اكتشاف المغناطيس ؟	ما هو المغناطيس ؟	no
أين تقع شركة جوجل ؟	ما هي شركة جوجل ؟	no
ما هي عمليات الانتاج ؟	ماذا نقصد بالانتاج ؟	no
ما هو لون زبدة الشيا؟	أين توجد زبدة الشيا؟	no
ما هي نسبة االصينيون في أستراليا؟	ما عدد المدن الموجودة في أستراليا؟	no
ما عاصمة أنغولا؟	ما عاصمة زيمبابوي؟	no
من طرق تحضير فطآئر البيبروني؟	من طرق تحضير بيتزا البيبروني؟	no
أين تقع بلجيكيا؟	ما هي اللغات السائدة في بلجيكيا؟	no
ما دور التكنولوجيا في الاستغناء عن الكتب؟	ما هي التكنولوجيا؟	no
من اساليب تكوين القيم ؟	من خصائص القيم ؟	no
ما هي قصيدة يا سليمى يا سليمى؟	من مؤلف قصيدة يا سليمى يا سليمى؟	no
ما هي نظرة الاسلام للسلام ؟	ما هو السلام ؟	no
كيف احضر قلاية البندورة؟	من طرق تحضير قلاية البندورة باللحم؟	no
ما تعريف الخطاب الإشهاري؟	ما الأُسس التي يَعتمد عليها بناء الخطاب الإشهاري؟	no
ما طريقة تحضير فطآئر البيبروني ؟	من طرق تحضير بيتزا البيبروني؟	no
لماذا سميت مدينة وهران بهذا الاسم؟	أين توجد مدينة وهران؟	no
ما هي اللغة الرسمية في كندا؟	ما لغة كيبك الرسمية؟	no
ما طريقة تحضير البروكلي بالثوم؟	من طرق تحضير البروكلي  ؟	no
كيف كان التصوير في عهد أرسطو؟	ما اسم اول شركة للتصوير؟	no
كيف انظف البشرة الحساسة ؟	ما هي البشرة الحساسة؟	no
لماذا تعتبر شبكات الكمبيوتر بهذه الأهمية؟	ما هي شبكات الكمبيوتر؟	no
ما هي طرق العناية بالبشرة؟	ما هي البشرة؟	no
ما النصائح الازمة للحصول على المال ؟	ما هو المال ؟	no
أين تقع سلوفينيا في قارة أوروبا؟	أين توجد سلوفاكيا؟	no
ما هي الأنيميا؟	ما هو الدم؟	no
في أي عام ولد أبو نواس؟	أين ولد أبو نواس؟	no
ضمن أي إقليم توجد محافظة إربد؟	كم يبلغ عدد سكان محافظة إربد؟	no
ما طريقة تحضير مافن الشوكولاتة الهش؟	من طرق تحضير  طريقة إعداد الشوكولاتة؟	no
كم تبلغ تكلفة بناء شنغهاي وورلد فينيشال سنتر؟	في أي عام تم بناء شنغهاي وورلد فينيشال سنتر؟	no
كيف احضر فيلية السمك مع الهليون؟	من طرق تحضير السمك؟	no
من سلبيات الخشاف ؟	ما طريقة عمل الخشاف ؟	no
كيف احضر البفتيك المقليّ؟	ما هو البفتيك؟	no
ما حكم صوم أيام التشريق؟	ما هي أيام التشريق؟	no
من طرق تحضير اصابع زينب بالشومر؟	طريقة تحضير اصابع زينب بالبهارات؟	no
ما هي نتائج الثورة الصناعية على الاقتصاد ؟	ما تعريف الثورة الصناعية ؟	no
كيف احضر حشوة المحشي بالفلفل؟	من طرق تحضير حشوة المحشي  ؟	no
لماذا سميت مدينة القدس بهذا الاسم؟	ما عاصمة فلسطين؟	no
ما أهمية تقنية المعلومات في مجال الطب؟	ماذا نقصد بتقنية المعلومات؟	no
ما هي انواع الثواليل؟	ما هي انواع مسمار اللحم؟	no
ما المقصود بغسيل الاموال ؟	من اشكال غسيل الاموال ؟	no
ما هي لغة الجمهورية الجزائرية؟	كم لغة مستخدمة في الجزائر؟	no
ما هي حالات الهوية ؟	ما هي البطاقة الشخصية ؟	no
ما هي الاسباب التي تمنع الغنى ؟	ما هي وسائل تحقيق الغنى؟	no
ما هي الحدود الشمالية الشرقية لقارة أفريقيا؟	ما هي حدود قارة أفريقيا الغربية؟	no
من هم اكثر عرضة للاصابة بالالتهابت الفطرية الجلدية؟	من هو اكثر عرضة للاصابة بالاتهابات؟	no
ما طريقة تحضير فطيرة الباستا فلورا اليونانية؟	من طرق تحضير  فطيرة الباستا فلورا  ؟	no
ما هي مسؤوليّات الإدارة؟	ما هي الادارة ؟	no
من عمليات الانتاج ؟	ماذا نقصد بالانتاج ؟	no
من طرق تحضير  سلطة كودو الدجاج؟	,من طرق تحضير  سلطة  الدجاج؟	no
لماذا ينحف الوجه؟	ما هي أسباب شحوب الوجه؟	no
من اساليب تكوين القيم ؟	من خصائص القيم ؟	no
ما دور التكنولوجيا في تطور مستوى المعلم؟	هل تؤثر التكنولوجيا على حياتنا؟	no
من أول شخص ألف لائحة للأماكن الخلابة؟	من هو المُلقّب بأبي التاريخ؟	no
ما هو طول سور الصين العظيم؟	ما هي الإمتدادات الحدزدية لسور الصين العظيم؟	no
في أي عام تم اختراع آلة تصوير الكوداك؟	ما هي آلة تصوير الكوداك؟	no
كيف أتخلص من الدهون على وجهي؟	ما هي طرق التخلص من دهون الجسم؟	no
ما العلامات التي تظهر على ضعيف الشخصية؟	ماذا نعني بالشخصية الضعيفة؟	no
كم تصل المساحة الإجمالية لإسبانيا؟	كم تصل المساحة الإجمالية لسلوفينيا؟	no
من طرق تحضير الشيش طاووق دون استخدام أسياخ؟	من طرق تحضير الشيش طاووق؟	no
هل هناك شهادات معينة يجب أن تكون عند مدير قواعد البيانات؟	ما هي صلاحيات مدير قواعد البيانات؟	no
ما هي الاعشاب لعلاج السعال؟	ما هي الاعشاب الطبية؟	no
ما اسم أهم قطاع في مدغشقر؟	ما عاصمة مدغشقر؟	no
ما هي حدود إسبانيا من الجهات الأربع؟	ما هي لغة إسبانيا الرسمية؟	no
ما طريقة تحضير لحم مشوي بولجوجي؟	من طرق تحضير لحم؟	no
ما اسم أكبر مدينة في الجمهورية الجزائرية؟	بماذا يتميز فصل الصيف في الجزائر؟	no
كم موظف تم تعيين للإنتهاء من بناء تاج محل؟	في أي عام تم الانتهاء من بناء تاج محل؟	no
ما هي القبيلة التي تحتوي على السكان الأصليون لنيوزلندا؟	ما هي اللغة النيوزلندية الرسمية؟	no
متى ظهر أول هاتف محمول بكاميرا؟	ما هو الهاتف المحمول؟	no
من هو محلل أنظمة المعلومات؟	ما هي أنظمة المعلومات؟	no
من طرق تحضير أرزّ برياني بالخضار؟	,من طرق تحضير الارز؟	no
متى احتلت فرنسا جزيرة هايتي؟	ما هي مساحة جزيرة هايتي؟	no
ما عملة جزر القمر؟	أين توجد جزر القمر؟	no
ما هي الديانة لمعظم دول الوطن العربي؟	ما هي ديانات الوطن العربي؟	no
ما اسم عاصمة إسبانيا؟	ما هي الديانة الرسمية لإسبانيا؟	no
ماذا نقصد بالألمنيوم؟	ما هو رمز الألمنيوم ؟	no
ما هو عدد القارات الموجودة في العالم؟	ما خصائص القارة؟	no
في أي بلد توجد مدينة مازاغان؟	متى تم السيطرة على مدينة مازاغان في المغرب؟	no
أين تقع ألبانيا في قارة أوروبا؟	ما هو موقع لوكسمبورغ في قارةة أوروبا؟	no
ما هو نموذج التفويض ؟	ما هو التفويض ؟	no
في أي عام اكتشف الصينيون قارة أستراليا؟	ما حال طقس أستراليا صيفاً؟	no
ما هي قصيدة لحن غجري؟	من قائل قصيدة لحن غجري؟	no
هل ينعم الفازلين الوجه؟	ما هي استخدامات الفازلين للجسم؟	no
هل هناك معادلة للميزانية ؟	ما هي الميزانية ؟	no
ماذا نقصد بالشعر؟	ما أهمية الشعر؟	no
ماذا نقصد بفن السرد؟	ما الهدف من فن السرد؟	no
ما معنى لفظة الحاجة؟	متى تؤدى صلاة الحاجة؟	no
كيف يتغير شكل أبو ذنيبة؟	كيف يكون جلد الضفدع؟	no
لماذا نصاب بالبهاق؟	ما هي اسباب البرص؟	no
ما هو مناخ نيوزلندا العام؟	ما هو العدد الإجمالي لسكان نيوزلندا؟	no
ما عدد سكان المغرب العربي؟	من هم السكان الحاصلين على الأكثر نسبتاً في المغرب؟	no
من منظمات تحقيق السلام ؟	ماذا نقصد بالسلم ؟	no
ما هي الادارة العليا ؟	ما تعريف الادارة  ؟	no
متى بدأت آلات التصوير في التطوّر؟	كيف تطورت آلات التصوير؟	no
ما النسبة المئوية للأوكرانييون الموجودون في روسيا؟	ما هي لغة روسيا الرسمية؟	no
ما انواع بطاقة الفيزا ؟	ما مكونات بطاقة الفيزا ؟	no
ما الأهمية التي تقدمها صور السيلفي؟	من اخترع صور السيلفي؟	no
كيف تؤثر وسائل الاتصال على المجتمع؟	ما عناصر وسائل الاتصال ؟	no
كم تبلغ مساحة مقدونيا؟	كم تصل المساحة الإجمالية للنرويج؟	no
ما هي العاصمة الرسمية لمدغشقر؟	ما هي الديانة المنتشرة بكثرة في مدغشقر؟	no
كيف أتجنب الغش عند شراء البروتينات الصناعية؟	ماذا أفعل لأتجنب حصى الكلى؟	no
كم عدد الموظفين الذي عملوا على بناء برج خليفة؟	كم يصل مقاد تكلفة بناء برج خليفة؟	no
ما هو أنواع العمل ؟	ما هو تعريف العمل؟	no
ماذا نقصد بالجمعيات الخيرية؟	ما هي اهداف الجمعيات الخيرية؟	no
من طرق تحضير البان كيك؟	من طرق تحضير البان كيك بالشوكولاتة؟	no
ما نظام الحكم في البرتغال؟	ما مساحة البرتغال؟	no
ما الأسباب التي تجعل لاعب كمال الأجسام يستخدم البروتين الصناعي؟	ما أهمية البروتين لعضلة لاعب كمال الأجسام؟	no
بماذا سمي فيتامين د؟	كيف نحصل على فيتامين د من الشمس؟	no
ما هو عنوان الـ URL؟	ما هو عنوان الـ URL؟	no
ما كمية القهوة التي ترفع من خطر الوفاة المبكرة للرجال تحت سن 55 عاماً؟	ما مقدار القهوة المناسبة لعمل فنجان لشخص واحد؟	no
ما اسم عاصمة ألمانيا؟	ما اسم عاصمة فنلندا؟	no
ما هي فائدة الأرز المطحون والعسل وصودا الخبز للبشرة؟	هل يفيد الأرز المطحون مع دقيق الصودا البشرة؟	no
كيف احضر حشوة التونة بالأناناس؟	من طرق تحضير حشوة التونة  ؟	no
ما طريقة تحضير موالح بالزعتر والجبنة ؟	من طرق تحضير معجنات بالزعتر والجبنة؟	no
ما مطلع  قصيدة أبيت أرمد ما لم اكتحل بكم؟	من مؤلف قصيدة أبيت أرمد ما لم اكتحل بكم؟	no
ما سبب تسمية الأردن بهذا الاسم؟	ما اسم الأردن الرسمي؟	no
ما عدد سكان المغرب العربي؟	من هم السكان الحاصلين على الأكثر نسبتاً في المغرب؟	no
